......###1........o
.####......2.####..
.#47####5o####..##.
....#4...>...#..7..
....###.#9#.##.#..o
##.oo...###....#.##
6.....#.#o#.#..oo3.
...####..2..#.##5..
##.8#.#######..#.##
#...#....G.o...#.#8
#.#3#6#######2.#o#.
#.#.#...oo.......#.
..o...###1###9##...

Niveau créé par Marc-Aurèle.
Ce fichier est dans le domaine public.
