......###1###.....o
.##.#.........#.##.
.##.#.###.#####.##.
.##.#....>..#...##.
......#.###...#...o
##.####.###.###.###
......#.#G#...#....
.####.......#.#.##.
......###.###.#....
.##.#.........#.##.
.#..#.#######...##.
.#.##.........#.##.
..o...###1###......

Niveau inspiré du jeu Greedy.
Ce fichier est dans le domaine public.
