.o........2.....o.
##########........
...........#######
#####.###.########
G..##...#^#......#
..............#...
#......########..o
.................#
.##########.....##
.......#....#....#
#######.#.#.##.#.#
1............#...1
o.........2.....o.

Niveau sorti tout droit de l'esprit de Lionel. ;-)
Ce fichier est dans le domaine public.
