##..###..1....#...o
.....#....#.#2..#.#
..##...##.#.#####..
..##.....>....#...#
#....####.#####....
...#....#.#...#.##.
##.#.##.#.#.#.#o.#.
...#.#...2..#.##.#.
...#.########......
.###.....G.......#.
.o#...#########..#.
..#...........#..#.
....o.###1###......

Niveau créé par Marc-Aurèle.
Ce fichier est dans le domaine public.
