####.#.#.#1.......o
.#...#.#.#.........
.##..#.....#...#...
..#........#...#...
..#..#.####v###.#..
G.......#...#...#.#
#..#....o...#.##...
######..#####.####.
..####.#...........
#......#.....######
#####......#.......
...........#.......
o#########1.....#.o

Niveau sorti tout droit de l'esprit de Lionel. ;-)
Ce fichier est dans le domaine public.
