......###1........o
.####......2.####..
.#4.####..####..##.
....#4...>...#.....
....###.#.#.##.#..o
##......###....#.##
......#.#o#.#....3.
...####..2..#.##...
##..#.#######..#.##
#...#....G.o...#.#.
#.#3#.#######2.#.#.
#.#.#............#.
..o...###1###.##...

Niveau créé par Marc-Aurèle.
Ce fichier est dans le domaine public.
